TITLE=Lotsa Lava
GEMS=2
SECONDS=60
BOMBS=2
MIDI=MIDI\WHITEBOY.MID
MOVE_DIRT_WAVE=WAVE\DIRT.WAV
ROCK_KILLS_MAN_WAVE=WAVE\SLOP.WAV
MOLE_KILLS_MAN_WAVE=WAVE\SLURP.WAV
GEM_KILLS_MAN_WAVE=WAVE\BREAK.WAV
PICKUP_GEM_WAVE=WAVE\GEM.WAV
PUSH_ROCK_WAVE=WAVE\GRUNT.WAV
OPEN_GATE_WAVE=WAVE\GATE.WAV
KILL_MOLE_WAVE=WAVE\EXPLOSIN.WAV
ROCK_FALL_WAVE=WAVE\ROCKFALL.WAV
GEM_FALL_WAVE=WAVE\GEM.WAV
B1B2B2B2B2B2B2B2B2B2B2B2B2B2B2B2B2B2B2B2B2B2
B1 0D0 0 0 0 0 0 0 0 0 0 0 0 0 0 0 0 0 0L5B1
B1 0B1 0B2B2B2B2B2B2B2B2B2B2B2B2B2B2B2B2B2B1
B1 0B1 0 0 0 0 0 0 0 0 0 0 0 0 0 0 0 0 0 0B1
B1B2B2B2B2B2B2B2B2B2B2B2B2B2B2B2B2B2B2B2 0B1
B1 0 0 0 0 0 0 0 0 0 0 0 0 0 0 0 0 0 0 0 0B1
X0 0B2B2B2B2B2B2B2B2B2B2B2B2B2B2B2B2B2B2B2B1
B1 0 0 0 0 0 0M0 0 0 0 0 0 0 0 0 0 0 0 0 0B1
B1B2B2B2B2B2B2B2B2B2B2B2B2B2B2B2B2B2B2B2 0B1
B1 0 0 0 0 0 0 0 0 0 0 0 0 0 0 0 0 0 0 0 0B1
B1 0B2B2B2B2B2B2B2B2B2B2B2B2B2B2B2B2B2B2B2B1
B1 0C2 0 0 0 0 0 0 0 0 0 0 0 0 0 0 0 0 0L9B1
B2B2B2B2B2B2B2B2B2B2B2B2B2B2B2B2B2B2B2B2B2B1

