TITLE=Monster Maze
GEMS=13
SECONDS=120
BOMBS=0
MIDI=MIDI\GOLDF.MID
MOVE_DIRT_WAVE=WAVE\DIRT.WAV
ROCK_KILLS_MAN_WAVE=WAVE\SLOP.WAV
MOLE_KILLS_MAN_WAVE=WAVE\SLURP.WAV
GEM_KILLS_MAN_WAVE=WAVE\BREAK.WAV
PICKUP_GEM_WAVE=WAVE\GEM.WAV
PUSH_ROCK_WAVE=WAVE\GRUNT.WAV
OPEN_GATE_WAVE=WAVE\GATE.WAV
KILL_MOLE_WAVE=WAVE\EXPLOSIN.WAV
ROCK_FALL_WAVE=WAVE\ROCKFALL.WAV
GEM_FALL_WAVE=WAVE\GEM.WAV
B4B4B4B4B4B4B4B4B4B4B4B4B4B4B4B4B4B4B4B4B4B4B4B4B4B4B4B4B4B4B4B4B4B4B4B4B4B4B4B4B4B4B4B4B4B4
B4M0 0 0 0 0 0 0 0 0 0 0 0 0 0 0 0 0 0 0 0 0 0 0 0 0 0B4 0 0 0 0 0 0 0B4a3 0 0 0 0 0 0 0 0B4
B4B4B4B4B4B4 0 0 0 0 0 0 0 0 0 0 0 0 0 0 0 0 0 0 0 0 0 0 0 0B4 0 0 0 0 0B4B4B4 0 0 0 0 0 0B4
B4 0 0 0 0B4B4B4B4 0 0 0B4B4B4B4B4 0B4B4B4B4B4B4B4B4B4B4B4B4B4B4 0 0 0 0 0 0 0B4B4B4 0 0 0B4
B4 0a5 0 0B4 0 0 0B4 0B4 0 0 0 0 0 0 0 0 0 0 0 0 0 0 0 0 0 0 0 0B4B4B4B4 0 0 0 0 0B4B4 0 0B4
B4 0B4 0 0B4 0 0 0B4 0 0B4B4B4 0 0 0 0 0B4B4B4 0B4B4B4B4 0 0 0 0 0 0 0 0B4B4 0 0 0 0B4 0B4B4
B4 0B4 0 0B4 0 0 0B4 0 0 0 0 0B4B4B4B4B4 0 0 0 0 0 0 0 0B4B4 0 0 0 0 0 0 0B4B4 0 0 0B4 0 0B4
B4 0B4 0 0B4 0 0 0B4B4B4 0 0 0 0 0 0 0 0 0 0 0 0 0 0 0 0 0B4 0 0 0 0 0 0 0 0B4 0 0 0B4B4 0B4
B4 0B4 0 0B4 0 0 0B4B4B4 0 0 0 0 0 0 0 0 0 0 0 0 0 0 0 0 0B4 0 0 0 0 0 0 0 0 0B4 0 0B4 0 0B4
B4 0B4 0 0B4 0 0 0 0 0 0B4 0 0B4B4B4B4B4B4B4 0B4B4B4B4B4B4B4 0 0 0B4B4 0 0 0 0B4 0 0B4 0B4B4
B4 0B4 0 0B4 0 0 0 0 0 0B4 0 0B4 0 0 0 0 0 0 0 0 0 0 0 0 0 0 0 0 0 0B4 0 0 0B4 0 0 0B4 0 0B4
B4 0B4 0 0B4 0 0 0 0 0 0B4 0 0B4 0 0 0 0 0 0 0 0 0B4B4B4B4 0 0 0B4 0B4B4 0 0B4 0 0 0B4B4 0B4
B4 0 0B4 0B4 0 0 0 0 0 0B4 0 0B4 0 0 0B4B4B4B4B4B4B4B4B4B4B4B4B4B4 0 0B4 0 0B4 0 0 0B4 0 0B4
B4 0 0B4 0B4 0 0 0 0B4B4B4 0 0 0B4 0 0 0 0 0 0 0 0 0 0 0 0 0 0 0 0 0 0B4 0 0B4 0 0 0B4 0B4B4
B4 0 0B4 0B4 0 0 0 0B4 0 0 0 0 0 0B4B4 0 0 0 0 0B4B4B4B4B4B4B4B4B4B4 0B4B4 0B4 0 0 0B4 0 0B4
B4 0 0B4 0B4 0 0 0 0B4 0 0 0 0 0 0 0 0B4B4B4B4B4 0 0 0B4 0 0 0B4 0B4 0 0B4 0B4a4 0 0B4B4 0B4
B4 0 0B4 0B4 0 0 0 0B4B4B4B4B4B4B4 0 0 0 0 0 0 0 0 0 0B4 0B4 0B4 0B4 0 0B4 0B4B4 0 0B4 0 0B4
B4 0 0B4 0B4B4 0 0 0 0 0 0 0 0 0 0 0 0 0 0 0 0 0 0 0 0B4 0B4 0B4 0B4 0 0B4 0 0B4 0 0B4 0 0B4
B4 0 0B4 0 0B4B4 0 0 0 0 0 0 0 0 0 0 0 0 0 0 0 0 0 0 0 0 0B4 0 0a7B4 0 0B4 0 0B4 0 0B4 0 0B4
B4 0 0B4 0 0 0B4B4B4B4B4B4B4B4B4B4B4B4B4B4B4B4B4B4B4B4B4B4B4B4B4B4B4 0 0B4 0 0B4 0 0B4 0 0B4
B4 0 0B4 0 0 0 0 0 0 0 0 0 0 0 0 0 0 0 0 0 0B4 0 0 0 0 0 0 0 0 0 0 0 0 0B4 0 0B4 0 0B4 0 0B4
B4 0 0B4 0 0 0 0 0 0 0 0 0 0 0 0 0 0 0 0 0 0 0B4 0 0 0 0 0 0 0 0 0 0 0 0B4 0 0B4 0 0B4 0 0B4
B4 0 0B4B4 0 0 0 0 0 0B4B4B4B4B4B4B4B4B4 0 0 0 0B4B4B4B4B4B4B4 0 0B4B4B4B4 0 0B4 0 0B4 0 0B4
B4 0 0 0B4B4 0 0 0B4B4 0 0 0 0 0 0 0 0 0B4 0 0 0B4 0 0 0 0 0B4 0 0B4 0 0B4 0 0B4 0B4B4B4 0B4
B4 0 0 0 0B4 0 0B4B4 0 0 0 0 0 0 0B4B4 0 0 0 0B4B4 0 0 0 0 0B4 0 0 0 0 0B4 0 0B4 0B4 0 0 0B4
B4 0 0 0B4 0B4B4B4 0 0 0 0 0 0B4B4 0 0B4B4B4B4B4B4B4B4 0 0 0B4 0 0 0 0B4 0 0 0B4 0B4 0B4 0B4
B4 0 0B4 0 0 0 0 0 0 0 0B4B4 0 0 0 0 0B4 0 0 0B4 0 0B4B4 0 0B4 0 0 0B4B4 0 0 0B4 0B4 0B4 0B4
B4 0 0B4 0 0 0 0 0 0 0B4 0 0 0 0 0 0B4 0 0 0B4 0 0 0 0B4 0 0B4B4B4B4B4 0 0 0 0B4 0B4 0B4 0B4
B4 0 0B4 0 0 0 0 0 0B4 0 0 0 0B4 0 0B4 0 0 0B4 0 0 0 0B4 0 0 0 0 0 0 0 0 0 0 0B4 0B4 0B4 0B4
B4 0 0B4 0 0 0 0 0 0B4 0 0B4B4B4 0 0B4 0 0 0B4 0 0 0 0B4 0 0 0 0 0 0 0 0 0 0B4 0 0B4 0B4 0B4
B4 0 0B4B4 0 0 0 0 0B4 0 0B4a1 0 0 0B4 0 0 0B4 0B4B4 0B4 0 0 0 0 0 0 0 0 0B4 0 0 0B4 0B4 0B4
B4 0 0 0B4B4B4 0 0 0B4 0 0B4B4B4B4B4B4 0 0 0B4 0B4 0 0B4 0 0 0 0 0 0 0B4B4B4 0 0B4 0 0B4 0B4
B4 0 0 0 0 0B4 0 0 0 0B4 0 0 0 0 0 0 0 0 0B4 0 0B4 0 0B4B4 0a0 0B4B4B4 0 0 0 0B4B4 0 0B4 0B4
B4 0 0 0 0 0B4 0 0 0 0 0B4 0 0 0 0 0 0 0B4B4 0 0B4 0 0 0 0B4B4B4 0 0 0 0 0 0 0B4 0 0B4B4D0B4
B4 0 0 0 0B4B4 0 0 0 0 0B4B4 0B4B4 0B4B4B4 0 0 0B4 0 0 0 0 0 0 0 0 0 0 0 0B4B4B4 0 0B4D0D0B4
B4 0 0 0 0B4 0 0 0 0 0 0 0 0 0 0 0 0 0 0 0 0 0 0B4 0B4B4B4B4B4B4B4B4B4B4B4 0 0 0 0 0B4D0D0B4
B4 0 0 0 0B4B4B4B4B4B4B4B4B4B4B4B4B4B4B4B4B4B4B4B4B4B4 0 0 0 0 0 0 0 0 0 0 0B4B4B4B4B4E0D0B4
B4 0 0 0 0 0 0 0 0 0 0 0 0 0 0 0 0 0 0 0 0 0 0 0 0 0 0 0 0 0 0 0 0 0 0 0 0 0B4D0D0D0D0D0D0X0
B4B4B4B4B4B4B4B4B4B4B4B4B4B4B4B4B4B4B4B4B4B4B4B4B4B4B4B4B4B4B4B4B4B4B4B4B4B4B4B4B4B4B4B4B4B4
