TITLE=Barrier Buster
GEMS=5
SECONDS=120
BOMBS=0
MIDI=MIDI\BFLATBLS.MID
MOVE_DIRT_WAVE=WAVE\DIRT.WAV
ROCK_KILLS_MAN_WAVE=WAVE\SLOP.WAV
MOLE_KILLS_MAN_WAVE=WAVE\SLURP.WAV
GEM_KILLS_MAN_WAVE=WAVE\BREAK.WAV
PICKUP_GEM_WAVE=WAVE\GEM.WAV
PUSH_ROCK_WAVE=WAVE\GRUNT.WAV
OPEN_GATE_WAVE=WAVE\GATE.WAV
KILL_MOLE_WAVE=WAVE\EXPLOSIN.WAV
ROCK_FALL_WAVE=WAVE\ROCKFALL.WAV
GEM_FALL_WAVE=WAVE\GEM.WAV
B6B6B6B6B6B6B6B6B6B6B6B6B6B6B6B6B6B6B6B6B6B6B6B6
B6 0 0 0 0 0 0 0 0 0 0S0 0 0 0 0 0 0 0 0 0 0 0B6
B6 0 0 0 0 0 0 0 0 0 0B1 0 0 0 0 0 0 0 0 0 0 0B6
B6 0 0 0 0 0 0 0 0 0 0B1 0 0 0a0 0 0 0 0 0 0 0X0
B6B6B6B6B6B6B6B6B6B6B6B6B6B6B6B6B6B6B6B6B6B6B6B6
B6 0 0 0 0 0 0 0 0 0 0 0 0 0 0 0 0 0 0 0 0 0 0B6
B6B7 0 0 0 0 0 0 0 0 0 0 0 0 0 0 0 0 0 0 0 0 0B6
B6B7B7 0 0 0 0 0 0 0 0 0S0 0 0 0 0 0 0 0 0 0 0B6
B6B6B6B6B6B6B6B6B6B6B6B6B6B6B6B6B6B6B6B6B6B6B6B6
B6 0 0 0 0 0 0 0 0 0 0 0 0 0 0 0 0 0 0 0 0 0 0B6
B6 0 0 0 0 0 0 0 0 0 0 0 0 0 0 0B6 0 0 0 0 0 0B6
B6 0 0 0 0 0 0 0 0 0 0 0 0 0 0 0B6 0 0 0 0 0 0B6
B6 0 0 0 0 0 0 0 0S0 0 0 0 0 0 0B6 0 0 0a7 0 0B6
B6 0 0 0 0B6B6B6B6B6B6B6B6B6B6B6B6B6B6B6B6B6B6B6
B6 0 0 0 0 0 0 0 0 0 0 0 0 0 0 0 0 0 0 0 0 0 0B6
B6 0 0 0 0 0 0 0 0 0 0 0 0s0 0 0 0 0 0 0 0 0 0B6
B6 0 0 0 0 0 0 0 0 0 0 0s0D3s0 0 0 0 0 0 0 0 0B6
B6 0 0 0 0 0 0 0 0 0 0s0D2s0D4D2 0 0 0 0 0 0 0B6
B6M0 0 0 0 0 0 0 0 0s0s0s0D0s0s0s0 0 0 0 0 0 0B6
B6B6B6B6B6B6B6B6B6B6B6B6B6B6B6B6B6B6B6B6B6B6B6B6
