TITLE=Chain Reaction
GEMS=1
SECONDS=20
BOMBS=0
MIDI=MIDI\CANYON.MID
MOVE_DIRT_WAVE=WAVE\DIRT.WAV
ROCK_KILLS_MAN_WAVE=WAVE\SLOP.WAV
MOLE_KILLS_MAN_WAVE=WAVE\SLURP.WAV
GEM_KILLS_MAN_WAVE=WAVE\BREAK.WAV
PICKUP_GEM_WAVE=WAVE\GEM.WAV
PUSH_ROCK_WAVE=WAVE\GRUNT.WAV
OPEN_GATE_WAVE=WAVE\GATE.WAV
KILL_MOLE_WAVE=WAVE\EXPLOSIN.WAV
ROCK_FALL_WAVE=WAVE\ROCKFALL.WAV
GEM_FALL_WAVE=WAVE\GEM.WAV
B2B2B2B2B2B2B2B2B2B2B2B2B2B2B2B2B2B2B2B2B2B2B2
B1M0 0 0 0 0 0 0 0 0 0 0 0 0S0 0 0 0 0 0 0 0B1
B1B7B7B7B7B7B7B7B7B7B7B7B7B7B7B7B7B7B7B7B7 0B1
B1S0S0S0S0S0S0S0S0S0T0S0S0S0S0S0S0S0S0S0S0S0B1
B1T0B7B7B7B7B7B7B7B7B7D0B7B7B7B7B7B7B7B7B7B7B1
B1S0S0S0S0S0S0S0S0S0S0S0S0S0S0S0S0S0S0S0S0S0B1
B1B7B7B7B7B7B7B7B7B7B7B7B7B7B7B7B7B7B7B7B7S0B1
B1S0S0S0S0S0S0S0S0S0S0S0S0S0S0S0S0S0S0S0S0S0B1
B1S0B7B7B7B7B7B7B7B7B7B7B7B7B7B7B7B7B7B7B7B7B1
B1S0S0S0S0S0S0S0S0S0S0S0S0S0S0S0S0S0S0S0S0S0B1
B1B7B7B7B7B7B7B7B7B7B7B7B7B7B7B7B7B7B7B7B7S0B1
B1B7S0S0S0S0S0S0S0S0S0S0S0S0S0S0S0S0S0S0S0S0B1
X0B7B7B7B7B7B7B7B7B7B7B7B7B7B7B7B7B7B7B7B7B7B1
B2B2B2B2B2B2B2B2B2B2B2B2B2B2B2B2B2B2B2B2B2B2B2
